WWWWWWWWWWWWWWWWWWWWWWWWWWWWWWWWWWWWWWWW
WDDDDDDDDDDDDDDDDDDDDDDDDDDDDDDDDDDDDDDW
WDDDDDDDDDDDDDDDDDDDDDDDDDDDDDDDDDDDDDDW
WDDDDDDDDDDDDDDDDDDDDDDDDDDDDDDDDDDDDDDW
WDDDDDDDDDDDDDDDDDDDDDDDDDDDDDDDDDDDDDDW
WDDDDDDDDDDDDDDDDDDDDDDDDDDDDDDDDDDDDDDW
WDDDDDDDDDDDDDDDDDDDDDDDDDDDDDDDDDDDDDDW
WDDDDDDDDDDDDDDDDDDDDDDDDDDDDDDDDDDDDDDW
WDDDDDDDDDDDDDDDDDDDDDDDDDDDDDDDDDDDDDDW
WDDDDDDDDDDDDDDDDDWWWWDDDDDDDDDDDDDDDDDW
WDDDDDDDDDDDDDDDDDDDDDDDDDDDDDDDDDDDDDDW
WDDDDDDDDDDDDDDDDDDDDDDDDDDDDDDDDDDDDDDW
WDDDDDDDDDDDDDDDDDDDDDDDDDDDDDDDDDDDDDDW
WDDDDDDDDDDDDDDDDDDDDDDDDDDDDDDDDDDDDDDW
WDDDDDDDDDDDDDDDDDDDDDDDDDDDDDDDDDDDDDDW
WDDDDDDDDDDDDDDDDDDDDDDDDDDDDDDDDDDDDDDW
WDDDDDDDDDDDDDDDDDDDDDDDDDDDDDDDDDDDDDDW
WDDDDDDDDDDDDDDDDDDDDDDDDDDDDDDDDDDDDDDW
WDDDDDDDDDDDDDDDDDDDDDDDDDDDDDDDDDDDDDDW
WWWWWWWWWWWWWWWWWWWWWWWWWWWWWWWWWWWWWWWW